###########
#.#....#..#
##..@.#.#.#
#.#....#..#
#.#...#...#
#...#.....#
#.#...#...#
...........
#..#...#..#
#.........#
###########